                                  #▓░░░░░░░░░░░░░░░░░░░░░░░░░░░░#                                   
                                  #░░░░░░░░░░░░░░░░░░░░░░░░░░░░░#                                   
                                  #░░░░░░░░░░░░░░░░░░░░░░░░░░░░░#                                   
                                  #░░░░░░░░░░░░░░░░░░░░░░░░░░░░░#                                   
                                  #░░░░░░░░░░░░░░░░░░░░░░░░░░░░░#                                   
                                  ########║░░░░░░░░░░░░░║########                                   
                                   #▓▓▓▓▓▓║░░░░░░░░░░░░░║▓▓▓▓▓▓#                                    
                                    #▓▓▓▓▓▓║░░░░░░░░░░░║▓▓▓▓▓▓#                                     
                                     #▓▓▓▓▓║░░░░░░░░░░░║▓▓▓▓▓#                                      
##########                            #▓▓▓▓▓║░░░░░░░░░║▓▓▓▓▓#                            ###########
░░░║░░░░░║#########################    #####║░░░░░░░░░║#####    #########################║.....║....
═══║═════║░░░░║▒▒▒▒║▒▒▒▒║▒▒▒▒║▒▒▒▒#    #░░░░░░░░░░░░░░░░░░░#    #░░░░║░░░░║....║....║....║═════║════
...║.....║════║════║════║════║════#    #░░░░░░░░░░░░░░░░░░░#    #════║════║════║════║════║.....║....
═══║═════║░░░░║░░░░║▒▒▒▒║▒▒▒▒║▒▒▒▒######░░░░░░░░░░░░░░░░░░░######▒▒▒▒║░░░░║░░░░║....║....║═════║════
...║.....║════║════║════║════║════#▓▓▓▓#░░░░░░░░░░░░░░░░░░░#▓▓▓▓#════║════║════║════║════║.....║....
═══║═════║....║░░░░║░░░░║▒▒▒▒║▒▒▒▒#▓▓▓▓#░░░░░░░░░░░░░░░░░░░#▓▓▓▓#▒▒▒▒║▒▒▒▒║░░░░║░░░░║....║═════║════
...║.....║════║════║════║════║════#▓▓▓▓#░░░░░░░░░░░░░░░░░░░#▓▓▓▓#════║════║════║════║════║.....║....
═══║═════║....║....║░░░░║░░░░║░░░░######░░░░░░░░░░░░░░░░░░░######▒▒▒▒║▒▒▒▒║▒▒▒▒║░░░░║░░░░║═════║════
...║.....║════║════║════║════║════#    #░░░░░░░░░░░░░░░░░░░#    #════║════║════║════║════║.....║....
═══║═════║....║....║....║░░░░║░░░░#    #░░░░░░░░░░░░░░░░░░░#    #▒▒▒▒║▒▒▒▒║▒▒▒▒║▒▒▒▒║░░░░║═════║════
...║.....║#########################    #####║░░░░░░░░░║#####    #########################║░░░░░║░░░░
##########                              #▓▓▓║░░░░░░░░░║▓▓▓#                              ###########
                                         #▓▓▓║░░░░░░░║▓▓▓#                                          
                                          #▓▓║░░░░░░░║▓▓#                                           
                                           #▓▓║░░░░░║▓▓#                                            
                                            ##║░░░░░║##                                             
                                          ###░░░░░░░░░###                                           
                                         #░░░░░░░░░░░░░░░#                                          
                                        #░░░░░░░░░░░░░░░░░#                                         
                                        (░░░░░░░░A░░░░░░░░)                                         
                                        #░░░░░░░░░░░░░░░░░#                                         
                                         #░░░░░░░░░░░░░░░#                                          
                                          ###░░░░░░░░░###                                           
                                            ##║░░░░░║##                                             