                                           #▓▓║░░░░░║▓▓#                                            
 Zvezda Service Module                      ##║░░░░░║##                                             
                                          ###░░░░░░░░░###                                           
                                         #░░░░░░░░░░░░░░░#                                          
                                        #░░░░░░░░░░░░░░░░░#                                         
                                        (░░░░░░░░A░░░░░░░░)                                         
                                        #░░░░░░░░░░░░░░░░░#                                         
                                         #░░░░░░░░░░░░░░░#                                          
                                          ###░░░░░░░░░###                                           
                                            ##║░░░░░║##                                             
                                           #▓▓║░░░░░║▓▓#                                            
                                          #▓▓║░░░░░░░║▓▓#                                           
                                         #▓▓▓║░░░░░░░║▓▓▓#                                          
##########                              #▓▓▓║░░░░░░░░░║▓▓▓#                              ###########
...║.....║#########################    #####║░░░░░░░░░║#####    #########################║░░░░░║░░░░
═══║═════║....║....║....║░░░░║░░░░#    #░░░░░░░░░░░░░░░░░░░#    #▒▒▒▒║▒▒▒▒║▒▒▒▒║▒▒▒▒║░░░░║═════║════
...║.....║════║════║════║════║════#    #░░░░░░░░░░░░░░░░░░░#    #════║════║════║════║════║.....║....
═══║═════║....║....║░░░░║░░░░║░░░░######░░░░░░░░░░░░░░░░░░░######▒▒▒▒║▒▒▒▒║▒▒▒▒║░░░░║░░░░║═════║════
...║.....║════║════║════║════║════#▓▓▓▓#░░░░░░░░░░░░░░░░░░░#▓▓▓▓#════║════║════║════║════║.....║....
═══║═════║....║░░░░║░░░░║▒▒▒▒║▒▒▒▒#▓▓▓▓#░░░░░░░░░░░░░░░░░░░#▓▓▓▓#▒▒▒▒║▒▒▒▒║░░░░║░░░░║....║═════║════
...║.....║════║════║════║════║════#▓▓▓▓#░░░░░░░░░░░░░░░░░░░#▓▓▓▓#════║════║════║════║════║.....║....
═══║═════║░░░░║░░░░║▒▒▒▒║▒▒▒▒║▒▒▒▒######░░░░░░░░░░░░░░░░░░░######▒▒▒▒║░░░░║░░░░║....║....║═════║════
...║.....║════║════║════║════║════#    #░░░░░░░░░░░░░░░░░░░#    #════║════║════║════║════║.....║....
═══║═════║░░░░║▒▒▒▒║▒▒▒▒║▒▒▒▒║▒▒▒▒#    #░░░░░░░░░░░░░░░░░░░#    #░░░░║░░░░║....║....║....║═════║════
░░░║░░░░░║#########################    #####║░░░░░░░░░║#####    #########################║.....║....
##########                            #▓▓▓▓▓║░░░░░░░░░║▓▓▓▓▓#                            ###########
                                     #▓▓▓▓▓║░░░░░░░░░░░║▓▓▓▓▓#                                      
                                    #▓▓▓▓▓▓║░░░░░░░░░░░║▓▓▓▓▓▓#                                     
                                   #▓▓▓▓▓▓║░░░░░░░░░░░░░║▓▓▓▓▓▓#                                    
                                  ########║░░░░░░░░░░░░░║########                                   
                                  #░░░░░░░░░░░░░░░░░░░░░░░░░░░░░#                                   
                                  #░░░░░░░░░░░░░░░░░░░░░░░░░░░░░#                                   
                                  #░░░░░░░░░░░░░░░░░░░░░░░░░░░░░#                                   
                                  #░░░░░░░░░░░░░░░░░░░░░░░░░░░░░#                                   
                                  #░░░░░░░░░░░░░░░░░░░░░░░░░░░░░#                                   
                                  #░░░░░░░░░░░░░░░░░░░░░░░░░░░░░#                                   
                                  (░░░░░░░░░░░░░░░░░░░░░░░░░░░░░)                                   
                                  (░░░░░░░░░░░░░░░░░░░░░░░░░░░░░)                                   
                                  (░░░░░░░░░░░░░░░░░░░░░░░░░░░░░)                                   
                                  #░░░░░░░░░░░░░░░░░░░░░░░░░░░░░#                                   
                                  #░░░░░░░░░░░░░░░░░░░░░░░░░░░░░#                         ########  
                                  #░░░░░░░░░░░░░░░░░░░░░░░░░░░░░#                     ####▓▓▓▓▓▓▓▓# 
                                  #░░░░░░░░░░░░░░░░░░░░░░░░░░░░░#                 ####▒▒▒▒▓▓▓▓▓▓▓▓▓#
                                  #░░░░░░░░░░░░░░░░░░░░░░░░░░░░░#             ####▒▒▒▒▓▓▓▓▓▓▓▓▓▓▓▓▓#
                                  ##########║░░░░░░░░░║##########         ####▒▒▒▒▓▓▓▓▓▓▓▓▓▓▓▓▓▓▓▓▓#
                                           #║░░░░░░░░░║#              ####▒▒▒▒▓▓▓▓▓▓▓▓▓▓▓▓▓▓▓▓▓▓▓▓▓#
                                  ####################################▒▒▒▒▒▓▓▓▒▓▓▒▒▓▓▓▒▒▓▓▒▒▓▓▓▓▓▓▓#
                        ###########▒▒▒▒▒▒▒▒▒▒▒▒▒▒▒▒▒▒▒▒▒▒▒▒▒▒▒▒▒▒▒▒▒▒▒▓▓▓▓▒▒▓▓▒▓▒▓▓▒▓▒▓▓▓▒▓▓▒▓▓▓▓▓▓▓
                      ###:::::::##▒▒▒▒▒▒▒▒▒▒▒▒▒▒▒▒▒▒▓▓▓▓▓▓▓▓▓▓▓▓▓▓▓▓▓▓▓▓▓▓▒▓▒▓▒▓▒▒▒▒▓▓▒▒▓▒▒▒▒▓▓▓▓▓▓▓
                   ##::::::::::##▓▓▓▓▓▓▓▓▓▓▓▓▓▓▓▓▓▓▓▓▓▓▓▓▓▓▓▓▓▓▓▓▓▓▓▓▓▓▓▓▓▒▓▓▒▒▓▒▓▓▒▓▒▒▓▓▒▓▓▒▓▓▓▓▓▓▓